################################
#                              #
#                              #
#                              #
#                              #
#              F               #
#          ##########          #
#         #          ##        #
#        #             #       #
#       #              #       #
#       #   ##    ##    #      #
#      #    ##    ##    #      #
#      #                #      #
#      #       ##       #      #
#      #                ##     #
#      #    ##            #    #
#  #  #       #           #    #
# # ##        #        ###     #
# #         ##        #       ##
# #                   #        #
#  #                 #         #
#  #                #        ###
#   #              #           #
#    ##          ##            #
#      ##########         ######
#                              #
#                              #
#                   ^###########
#                              #
#              @               #
###############I################
################################
